111111111111111111111111111111111111
100000000000000000000000000000000001
100000000000000000000000000000000001
100000000000000000000000000000000001
100000000000000000000000000000000001
100000000000000C00000000000000000011
1000000000000000000000000000000001E1
10000000000000000000P000000000000011
100000000000000000000000000000100001
100000000000000000000000000001E10001
111111111111111111111111111111111111